60
1111111111 1111111111 1111111111 1111111111 1111111111 1111111111
1862422100 0581000100 0040050001 1111111100 0000000010 0000050001
1111005006 0011002000 0000400601 0000000100 0040500010 0005000001
1005000500 0000001000 0400600001 0111110100 0400004010 0050005001
1110001200 8000111000 0000500001 0100710100 0044000110 0000000001
1001001000 0001004000 0000020501 0100110100 0005001110 0000000501
1001000200 4001000000 0222020001 0100000100 0005001111 0000700001
1000100000 0001050550 0022082201 0111111100 0500001010 0000000001
1000100000 0110060000 0002222000 0000000000 0050000110 0000030001
1001000000 0100500600 0000222000 0000000000 0000000010 0000000001 

1001111000 0100000000 0000000000 4444005555 0000600000 0040000001
1000500100 0012111000 0000000010 4444005555 0040500000 0000040001
1050040810 0000001000 0000110001 4444005555 0006000000 0000000001
1006000602 0050000200 0050010000 4444005555 0040005000 0000500001
1400400601 0005005010 0050010500 0000800000 0000006000 0000000001
1060000501 0505500000 0050001000 6666666666 0000500000 0040080001
1000400010 0000011000 0501000520 0000000000 0000006000 0000400001
1050001100 0000000010 0011107000 5555555555 0000400000 0000000501
1000010000 0040500000 0204005000 0004005000 0400500000 0040000001
1111100000 8000400500 0020004000 0050004000 0000040000 0005050001

1000020008 0850022200 0002111111 0000000000 2222222222 0006000401
1001010000 8000202000 0000011111 0000000000 2222222222 0006006001
1000001000 0010000000 0000000000 0000082222 2222222222 0000000001
1211111000 0010000000 0011110000 2222222222 2222222222 0000600601
1000050000 0100100020 0001100000 2222222222 2222222222 0050860001
1006000000 0002000000 0011110000 2222272222 2222282222 0660000001
1000040000 0000010000 0000000000 2222222222 2222222222 0660060001
1000004000 0020000000 0000400000 2222222222 2222222222 0000000001
1000000000 0000022000 0000005000 0000000000 2222222222 0000006001
1000000000 0002000000 0000000000 0000000000 2222222222 0000000001

1000001000 0000000000 0000111001 0001000000 0000001000 0000010001
1001000000 0000011000 0000000000 0000000000 0100000100 0000000001
1000007000 0000000000 0000010000 0100100000 0001000000 0000000001
1000010000 0001000000 0000000000 1000001000 0001080000 0010100101
1001000001 0000020000 0000011000 0010000000 0011000000 0001000001
1000100000 0000002200 0008000000 0000010000 0000000000 0000010001
1000000000 0002200000 0000010000 0010001000 0070001000 0101080001
1001000010 0001000000 0100000000 0000000000 0001000011 0000100001
1000080100 0010001000 0001010000 0010011000 0010000000 0000001001
1001001000 0010010100 0001110000 0010001000 0001000000 0001001001

1222222222 2222222222 2222222222 2222222222 2222222222 2222222221
1222222222 2222222222 2222222222 2222222222 2222222222 2222222221
1222222222 2222222222 2222222222 2222222222 2222222222 2222222221
1000000000 0000080000 0000000000 0000000000 0000000000 0000000001
1000000000 0000000000 0000000000 0000800000 0000000000 0000000001
1000000000 0000000000 0007000000 0000000000 0000000000 0000000001
1000070000 0000000000 0000000000 0000000000 0000000000 0000000001
1000000000 0000000000 0000000000 0000000000 0000000000 0000000001
1000008000 0000000000 0000000000 0000000000 0000000000 0000000001
1000000000 0000000000 0000000000 0000000000 0000000000 0000800001

1000000000 0000000000 0000000000 0000000000 0000000000 0000000001
1000000000 0000000000 0000000000 0000000000 0000000000 0000000001
1000000000 0000000000 0000000000 0000000000 0000000000 0000000001
1000000000 0000000000 0000000000 0000000000 0000000000 0070000001
1000000000 0000000000 0000000080 0000000000 0000000000 0000000001
1000000000 0000000000 0000000000 0000000000 0000000000 0000000001
1000000000 0000000000 0000000000 0000000000 0000000000 0000000001
1000700000 0000800000 0000000000 0000008000 0000000000 0000000001
1000000000 0000000000 0000000000 0000000000 0000000000 0000000001
1111111111 1111111111 1111111111 1111111111 1111111111 1111111111